1111111111
1000100E01
100000C001
10C0000001
1000000001
100C00C001
1111110111
10P0000001
100000C001
1000000001
1000000001
1111111111