11111111111
10000P00001
1000C000C01
1000000E001
11111111111